11001001
00000000
00101100
00000001
00000000
10101100
00000100
00000111
11011011
11010000
10000111
00001111
00001000
10100100
00101100
00001001
11100000
10001101
00001110
00011001
00000000
01111000
10101110
10001000
01001000
10010001
01000101
01100110
01011101
10000011
00010101
01100000
00000000
00111010
00010010
10100000
10010000
00000101
00000000
11111111
11111111
11111111
11111111
10111111
00101001
00111000
10001010
11000011
00000111
01001100
01000000
10010111
00000100
10101000
00111000
10001011
00001100
00000000
00011100
01010100
11101100
10101101
11001000
00100010
00110011
01000101
10001000
00001010
00110000
00000000
00011101
00001001
01010000
11001000
00000010
10000000
11111111
11111111
11111111
11111111
00000010
00001011
10010000
00000001
00010100
00111100
00100000
11100000
10110111
11110110
01001001
01110001
11111000
00000000
01001000
11101000
10010010
00000000
00000000
00000000
00000000
00000000
00000000
00000000
00000000
11100110
00010101
01011001
01100100
10111010
00001000
01010001
00000001
00000110
10100000
00100011
00000001
00001010
01011001
00000000
11110000
11111111
11111111
11111111
01011111
01100000
00000001
00001101
10000000
10000010
00000111
00000100
11111100
00010000
10111110
00111001
00001110
00011111
10010000
01100111
01011010
00010010
10100000
00011101
00111000
00110010
00000000
01101111
11001100
00110001
10000000
00100010
10001011
01001100
00011001
00100001
00101010
11000000
00000000
01110100
00100100
01000000
00100001
00001011
00000000
11111110
11111111
11111111
11111111
00001011
00101100
11110000
00111110
01010000
11110000
10000000
10000000
10011111
10111110
00100011
11000101
11100001
00000011
00100000
10100001
01001011
00000010
00000000
00000000
00000000
00000000
00000000
00000000
00000000
01011000
01010001
01100100
10010001
01011001
00100010
01000100